48 48
2 2 2 2 2 79 80 2 2 2 88 0 0 0 87 2 2 2 2 2 2 129 2 2 2 2 2 2 2 2 2 2 2 2 44 0 0 0 0 0 0 0 0 0 0 0 0 0
46 46 46 46 46 46 46 46 33 2 88 0 0 0 87 2 82 32 46 46 46 46 46 46 46 46 46 33 2 81 2 2 2 2 44 0 0 0 0 0 0 0 0 0 0 0 0 0
0 0 0 0 0 0 0 0 43 81 88 0 0 0 87 2 2 44 0 0 0 0 0 0 0 0 0 43 2 2 2 2 83 2 44 0 0 0 0 0 0 0 0 0 0 0 0 0
0 0 3 4 5 0 0 0 45 90 91 0 0 0 89 90 90 47 0 0 0 0 0 0 0 0 0 45 46 46 46 46 46 46 47 0 0 0 0 0 0 0 0 0 0 0 0 0
0 0 6 7 8 0 0 0 0 0 0 0 0 0 0 0 0 0 0 0 0 0 0 0 0 0 0 0 0 0 0 0 179 180 180 0 0 0 0 0 0 0 0 0 0 0 0 0
0 0 6 7 8 0 0 0 0 0 0 0 0 0 0 0 0 0 0 0 0 0 0 0 0 0 0 0 0 0 0 0 182 0 0 0 0 0 0 0 0 0 0 0 0 0 0 0
0 0 9 10 11 0 0 0 0 0 0 0 0 0 0 0 0 0 0 0 0 0 0 0 0 0 0 0 0 0 0 0 182 0 0 0 0 0 0 0 0 0 0 0 0 0 0 0
0 0 0 0 0 0 0 0 0 0 0 0 0 0 40 41 41 42 0 0 0 0 0 0 0 0 0 0 0 0 0 0 182 0 0 0 0 0 0 0 0 0 0 0 0 0 0 0
0 0 0 0 0 0 0 0 0 0 0 0 0 0 43 2 2 44 0 0 0 0 0 0 0 0 0 0 0 0 0 0 182 0 153 0 0 0 0 0 0 0 0 0 0 0 0 0
0 0 0 0 0 0 0 0 0 0 0 0 0 0 43 129 2 44 0 0 0 0 0 0 0 0 0 0 0 0 0 0 182 0 0 0 0 0 0 0 0 0 0 0 0 0 0 0
0 0 0 0 0 0 0 0 0 0 0 0 0 0 43 2 2 44 0 0 0 0 0 0 0 0 0 0 0 0 0 0 182 0 0 0 0 0 0 0 0 0 0 0 0 0 0 0
0 0 0 0 0 0 0 0 0 0 0 0 0 0 43 2 2 44 0 0 0 0 0 0 0 0 0 0 0 0 0 0 182 0 0 0 0 0 0 0 0 0 0 0 0 0 0 0
0 0 0 0 0 0 0 0 0 0 0 0 0 0 43 2 2 44 0 0 0 0 0 0 0 0 0 0 0 0 0 0 0 0 0 0 0 0 0 0 0 0 0 0 0 0 0 0
0 0 0 0 0 0 0 0 0 0 0 0 0 0 43 2 2 44 0 0 0 0 0 0 0 0 0 0 0 0 0 0 0 0 0 0 0 0 0 0 0 0 0 0 0 0 0 0
0 0 0 0 0 0 0 0 0 0 0 0 0 0 43 2 2 44 0 0 0 0 0 0 0 0 0 0 0 0 0 0 182 0 0 0 0 0 0 0 0 0 0 0 0 0 0 0
0 0 0 0 0 0 0 0 0 0 0 0 0 0 43 2 2 44 0 0 0 0 0 0 0 0 0 0 0 0 0 0 182 0 0 0 0 0 0 0 0 0 0 154 0 0 0 0
0 0 0 0 0 0 0 0 0 0 0 0 0 0 43 2 2 44 0 0 0 0 0 0 0 0 0 0 0 0 0 0 182 0 0 0 0 0 0 0 0 0 0 0 0 0 0 0
0 0 0 0 0 0 0 0 0 0 0 0 0 0 43 2 2 44 0 0 0 0 0 0 0 0 0 0 0 0 0 0 182 0 0 0 0 0 0 0 0 0 0 0 0 0 0 0
0 0 0 0 0 0 0 0 0 0 0 0 0 0 43 2 2 44 0 0 0 0 0 0 0 0 0 0 0 0 0 0 182 0 157 158 159 0 0 0 0 0 0 0 0 0 0 0
0 0 0 0 0 0 0 0 0 0 0 0 0 0 43 2 2 44 0 0 0 0 0 0 0 0 0 0 0 0 0 0 182 0 160 161 162 0 0 0 0 0 0 0 0 0 0 0
0 0 0 3 4 5 0 0 0 0 0 0 0 0 43 2 2 44 0 0 0 0 0 0 0 0 0 0 0 0 0 0 182 0 0 0 0 0 0 0 0 0 0 0 0 0 0 0
0 0 0 6 7 8 0 0 0 0 0 0 0 0 43 2 129 44 0 0 0 0 0 0 0 0 0 0 0 0 0 0 182 0 0 0 0 0 0 0 0 0 0 0 0 0 0 0
0 0 0 9 10 11 0 0 0 0 0 0 0 0 43 2 2 44 0 0 0 0 0 0 0 0 0 0 0 0 0 0 19 0 0 0 0 0 0 0 0 0 0 0 0 0 0 0
0 0 0 0 0 0 0 0 0 0 0 0 0 0 43 2 2 44 144 145 145 145 146 0 0 0 0 0 0 0 0 0 19 0 0 0 84 85 85 85 85 85 85 86 0 0 0 0
0 0 0 0 0 0 0 0 0 0 0 0 0 0 43 2 2 44 147 148 148 148 149 0 0 0 0 0 0 0 0 0 19 0 0 0 87 2 2 2 2 2 2 88 0 0 0 0
0 0 0 0 0 0 0 0 0 0 0 0 0 0 43 2 2 44 150 151 151 151 152 0 0 0 0 0 0 0 0 0 19 0 84 85 95 90 90 90 90 90 90 91 0 0 0 0
0 0 0 0 0 0 0 0 0 0 0 0 0 0 43 2 2 44 0 0 0 0 0 0 0 0 0 0 0 0 0 0 19 0 96 97 98 0 0 0 0 0 0 0 0 0 0 0
0 0 0 0 0 0 0 0 0 0 0 0 0 0 43 130 131 44 0 0 0 0 0 0 0 0 0 0 0 0 0 0 22 23 99 100 101 23 23 23 23 23 23 23 23 23 23 23
0 0 0 0 0 0 0 0 0 0 0 0 0 0 43 132 133 44 0 0 0 0 0 0 0 0 0 0 0 0 0 0 25 26 99 100 101 26 26 26 26 26 26 26 26 26 26 26
0 0 0 0 0 0 0 0 0 0 0 0 0 0 43 2 2 44 0 0 0 0 0 0 0 0 0 0 0 0 0 0 0 0 99 100 101 0 0 0 0 0 0 0 0 0 0 0
0 0 0 0 0 0 0 0 0 0 0 0 0 0 43 2 2 34 41 41 41 41 41 41 41 41 41 41 41 41 41 41 41 41 102 103 104 41 41 41 41 41 41 41 41 41 41 41
0 0 0 0 0 0 0 0 0 0 0 0 0 0 43 2 2 2 2 2 2 2 2 2 2 2 2 2 2 2 2 2 2 2 105 106 107 2 2 2 2 2 2 2 2 2 2 2
0 0 0 0 0 0 0 0 0 0 0 0 0 0 43 2 2 32 46 46 46 46 46 46 46 46 46 46 46 46 46 46 46 46 46 46 46 46 46 46 46 46 46 46 46 46 46 46
0 0 0 0 0 0 0 0 0 0 0 0 0 0 45 46 46 47 0 0 0 0 0 0 0 0 0 0 0 0 0 0 19 0 0 0 0 0 0 0 0 0 0 0 0 0 0 0
0 0 0 0 0 0 0 0 0 0 0 0 0 0 0 0 0 0 0 0 0 0 0 0 0 0 0 0 0 0 0 0 22 23 23 23 23 23 23 23 23 23 23 23 23 23 23 23
0 0 0 0 0 0 0 0 0 0 0 0 0 0 0 0 0 0 0 0 0 0 0 0 0 0 0 0 0 0 0 0 25 26 26 26 26 26 26 26 26 26 26 26 26 26 26 26
0 0 0 0 0 0 0 0 0 0 0 0 0 0 0 0 0 0 0 0 0 0 0 0 0 209 210 0 0 0 0 0 0 0 0 0 0 0 0 0 0 0 0 0 0 0 0 0
0 0 0 0 0 0 0 0 0 0 0 0 0 0 0 0 0 0 61 0 0 0 0 0 0 211 212 0 0 0 0 0 0 0 0 0 0 0 0 0 0 0 0 0 0 0 0 0
0 0 0 0 0 0 0 0 0 0 0 0 0 0 69 64 64 64 64 64 64 64 64 64 64 64 64 64 68 0 0 0 0 0 0 0 0 0 0 0 0 0 0 0 0 0 0 0
0 0 0 0 0 0 0 0 0 0 0 0 0 0 62 1 1 1 1 1 1 1 1 1 1 1 1 1 60 0 0 0 0 69 64 64 64 64 64 64 64 64 64 64 64 64 64 68
0 0 0 0 0 0 0 0 0 0 0 0 0 0 62 1 1 1 1 1 1 1 1 1 1 1 1 1 60 0 0 0 0 62 1 1 1 1 1 1 1 1 1 1 1 1 1 60
0 0 0 0 0 0 0 0 0 0 0 0 0 0 62 1 1 1 1 1 1 1 1 1 1 1 1 1 63 64 64 64 64 65 1 1 232 1 1 1 1 1 1 1 1 1 1 60
0 0 0 0 0 0 0 0 0 0 0 0 0 0 62 1 1 1 1 1 1 1 1 1 1 1 1 1 1 1 1 1 1 1 1 1 1 1 57 58 58 58 59 1 1 1 1 60
0 0 0 0 0 0 0 0 0 0 0 0 0 0 62 1 1 1 1 1 1 1 1 1 1 1 1 1 1 1 1 1 1 1 1 1 1 1 60 61 61 61 62 1 1 1 1 60
0 0 0 0 0 0 0 0 0 0 0 0 0 0 62 1 1 1 1 1 1 1 1 1 1 1 1 1 1 1 1 1 1 1 1 1 1 1 63 64 64 64 65 1 1 1 1 60
0 0 0 0 0 0 0 0 0 0 0 0 0 0 62 1 1 1 1 1 1 1 1 1 1 1 1 1 57 58 58 58 58 59 241 242 243 1 1 1 1 1 1 1 1 1 1 60
0 0 0 0 0 0 0 0 0 0 0 0 0 0 62 1 1 1 1 1 1 1 1 1 1 1 1 1 60 0 0 0 0 62 245 246 247 1 1 1 1 1 1 1 1 1 1 60
0 0 0 0 0 0 0 0 0 0 0 0 0 0 67 58 58 58 58 58 58 58 58 58 58 58 58 58 66 0 0 0 0 67 58 58 58 58 58 58 58 58 58 58 58 58 58 66