64 48
0 0 0 0 0 0 0 0 0 0 0 0 0 0 0 0 0 0 0 0 0 0 0 0 0 0 0 0 0 0 0 0 0 0 0 0 0 0 0 0 0 0 0 0 0 0 0 590 0 0 0 0 0 0 0 0 684 686 0 0 0 0 0 0
0 0 0 0 0 0 0 0 0 0 0 0 0 0 0 0 0 0 0 0 0 0 0 0 0 0 0 0 0 0 0 0 0 0 0 0 0 0 0 0 0 0 0 0 0 0 0 0 0 0 0 0 0 0 0 0 688 690 0 0 0 0 0 0
0 0 0 0 0 0 0 0 0 0 0 0 0 0 0 0 0 0 0 0 0 0 0 0 0 0 0 684 686 0 0 0 0 0 0 0 0 0 0 0 0 0 0 0 614 0 0 0 0 0 0 0 0 0 0 0 0 0 0 0 0 0 0 0
0 0 0 0 0 0 0 0 0 0 0 0 0 0 0 0 0 0 0 0 0 0 0 0 0 0 0 688 690 0 0 0 0 0 0 0 0 0 0 0 0 0 0 0 0 0 0 0 0 0 0 0 0 0 0 0 0 0 0 0 0 0 0 0
0 0 0 0 0 0 0 0 0 0 0 0 0 0 0 0 0 0 0 0 0 0 0 0 0 0 0 0 0 0 0 0 0 0 0 0 0 0 0 0 21 0 0 0 76 77 77 77 77 77 77 77 77 77 77 78 0 0 0 0 0 0 0 0
301 302 303 0 0 0 0 0 0 0 0 0 0 0 0 0 0 0 0 0 0 0 0 0 0 0 0 0 0 0 0 0 0 0 0 0 0 0 0 0 0 0 0 0 91 92 92 92 92 92 92 92 92 92 92 93 0 0 0 0 0 0 0 0
126 123 124 127 0 0 0 0 0 0 0 0 0 0 0 0 0 0 0 0 0 0 0 0 0 0 0 0 0 0 0 0 0 0 0 0 0 0 0 0 0 0 0 0 91 92 92 92 92 94 95 92 92 92 92 93 0 0 0 612 0 0 0 0
316 317 328 332 0 0 0 0 0 0 0 0 0 0 0 0 0 0 0 0 0 0 0 0 0 716 0 0 0 0 0 0 0 0 0 0 0 0 0 0 0 0 0 0 91 92 94 95 92 92 92 92 94 95 92 93 0 0 0 0 0 0 0 0
0 0 0 334 0 0 0 0 0 0 0 0 0 664 0 0 0 0 0 0 0 0 0 0 0 720 0 0 0 0 0 0 0 0 0 0 0 0 0 0 0 0 0 0 91 92 92 92 92 92 92 92 92 92 92 93 0 0 0 0 0 0 0 0
0 0 0 0 333 718 0 0 0 0 0 0 0 670 0 0 716 0 0 0 0 0 0 0 0 722 0 0 0 0 0 0 0 0 0 0 0 0 0 21 0 720 0 0 91 92 92 92 94 95 92 92 92 97 98 93 0 0 352 353 354 0 0 0
0 0 0 0 0 0 0 720 0 0 0 0 0 0 0 0 0 0 0 0 0 0 0 0 0 0 0 0 0 0 0 0 0 0 0 0 0 0 0 0 0 722 0 0 0 0 0 0 0 0 0 0 334 0 0 0 0 0 355 356 357 0 0 0
0 0 0 716 0 0 0 722 0 0 0 0 0 0 0 0 0 0 0 0 0 0 0 0 0 0 0 0 0 0 0 0 0 0 0 0 0 0 0 21 0 0 0 342 0 0 0 0 0 0 0 0 0 292 293 294 0 0 0 0 0 0 0 0
0 0 0 0 0 0 0 0 0 0 0 0 0 0 0 0 0 0 0 0 0 0 0 0 0 0 0 0 0 0 0 0 0 0 0 0 0 0 0 0 0 0 0 0 0 0 0 0 0 0 0 0 0 295 296 297 0 0 0 0 0 0 0 0
0 0 0 0 0 0 0 0 0 0 0 720 0 0 0 0 0 0 0 0 0 0 0 0 0 0 0 0 0 0 0 0 0 0 0 0 0 0 0 0 0 0 0 0 348 349 0 0 0 0 21 0 0 298 299 300 0 0 0 720 0 0 0 0
0 0 0 0 0 0 0 0 0 0 0 722 0 0 0 0 0 0 0 0 0 0 0 0 0 0 616 0 4 4 4 4 4 0 0 0 0 0 0 0 0 0 0 21 350 351 0 608 0 0 0 0 0 0 0 0 0 0 0 722 0 0 326 0
0 0 0 0 0 0 0 0 0 0 0 0 0 0 0 0 60 61 61 61 61 61 61 61 61 61 61 61 61 61 61 61 61 61 61 61 61 61 61 61 62 0 0 0 0 0 0 0 0 0 0 0 0 0 0 0 0 0 0 0 0 0 0 0
0 0 0 0 0 0 0 0 0 0 0 0 0 0 0 5 84 90 108 108 108 108 108 108 108 108 108 108 108 108 108 108 108 108 108 108 108 108 108 89 85 0 0 0 0 0 0 0 0 0 0 0 0 0 0 0 0 0 0 0 0 612 0 0
0 0 0 1 5 0 0 0 2 0 0 13 0 0 0 0 84 85 222 223 223 223 223 223 223 225 226 223 223 223 223 223 223 223 223 223 223 223 224 84 85 0 0 0 0 0 0 0 326 0 0 0 0 0 0 0 358 359 360 0 0 0 0 0
0 0 0 0 1 5 0 4 5 0 2 0 0 0 0 0 84 85 238 239 239 239 239 239 239 239 239 239 239 239 239 239 239 239 239 239 239 239 240 84 85 0 0 0 0 0 0 0 0 0 0 0 0 0 0 0 361 362 363 0 0 0 0 0
0 0 0 0 0 0 0 0 0 0 0 0 0 0 0 0 84 85 123 123 123 123 123 123 123 123 123 123 123 123 123 123 123 123 123 123 123 123 613 84 85 0 0 0 0 0 0 0 0 0 0 0 0 0 0 0 0 0 0 0 0 0 0 0
0 0 0 0 2 0 0 12 0 0 0 590 0 0 0 0 84 85 123 123 123 123 123 123 123 123 123 123 123 123 123 123 123 123 577 123 123 123 123 84 85 0 720 0 0 0 0 0 0 0 0 0 0 0 0 0 0 0 0 0 0 0 0 0
0 0 0 0 0 0 0 0 0 0 0 0 0 0 0 0 84 85 123 123 123 123 505 123 123 123 123 123 123 123 123 123 123 123 579 123 123 123 123 84 85 0 722 0 0 0 0 0 0 0 0 0 0 0 0 0 0 0 0 0 0 0 0 342
0 0 0 0 0 0 0 0 0 0 0 0 0 0 0 0 84 85 123 123 123 123 507 123 123 123 123 123 123 123 123 123 561 123 123 123 123 123 123 84 85 0 0 0 0 0 0 342 0 0 0 0 0 0 590 0 0 0 0 0 0 0 0 0
0 0 0 0 0 0 0 0 0 0 0 0 0 0 600 0 84 85 123 132 123 123 123 123 123 123 123 123 123 123 132 123 123 123 123 123 123 123 123 84 85 0 0 0 0 0 0 0 0 0 0 0 0 0 0 0 0 0 0 0 0 0 0 0
0 0 0 0 0 0 596 0 0 0 0 0 0 0 0 0 84 85 123 123 123 123 123 123 123 123 123 123 123 123 123 123 123 123 123 123 123 123 123 84 85 0 0 0 0 0 0 0 0 0 0 0 0 0 0 0 0 0 0 0 0 0 0 0
0 0 0 0 0 0 0 0 0 0 0 0 0 0 0 0 84 85 123 123 123 123 123 123 123 123 123 123 123 123 123 123 123 123 123 123 123 123 123 84 85 0 0 0 0 0 0 0 0 0 0 0 0 0 0 0 0 0 0 0 0 0 0 0
0 0 0 0 0 0 0 0 0 0 0 0 0 0 0 0 84 85 123 123 123 123 123 123 123 123 123 123 123 123 123 123 123 123 123 123 123 123 123 84 85 0 0 0 0 0 0 0 0 0 0 718 0 0 0 720 0 0 604 0 0 0 0 0
0 0 532 0 0 0 0 0 0 0 0 0 0 0 0 0 84 85 123 123 123 123 123 123 123 123 593 595 123 123 123 123 123 123 123 123 123 123 123 84 85 0 0 0 0 0 0 0 0 0 0 0 0 0 0 722 0 373 374 0 0 0 0 0
0 0 534 0 0 0 0 0 0 566 0 0 600 0 0 0 84 85 123 123 123 123 123 123 123 123 123 123 123 123 123 123 123 123 123 123 123 123 529 84 85 0 0 0 0 0 0 0 0 0 0 0 0 0 0 0 0 375 376 0 0 0 0 0
0 0 0 0 0 0 0 0 0 0 0 0 0 0 590 0 84 85 123 123 123 123 123 123 123 123 123 123 123 123 123 123 123 123 123 123 123 123 123 84 85 0 0 0 0 0 0 0 0 0 0 0 0 0 0 0 0 377 378 0 0 0 0 0
0 0 0 0 0 0 0 0 0 0 0 0 0 0 0 0 84 85 123 123 123 123 123 123 123 123 123 123 123 123 123 123 533 123 123 123 123 123 123 84 85 0 0 0 0 0 0 0 0 0 0 0 0 0 0 0 0 377 378 0 0 0 0 0
0 0 0 0 2 0 0 0 0 0 0 0 0 0 0 0 84 85 561 123 123 123 123 123 123 123 123 123 123 123 123 123 535 123 123 123 123 123 123 84 85 0 0 0 0 0 0 0 0 616 0 0 0 0 0 0 0 377 378 0 0 0 0 0
0 592 594 558 1 0 0 0 0 0 0 0 367 0 0 0 84 85 123 123 123 123 123 123 123 123 123 123 123 123 123 123 123 123 123 123 123 123 123 84 85 0 0 0 0 0 0 0 0 0 0 0 0 0 0 0 0 379 380 0 0 0 0 0
0 0 0 0 3 0 0 0 0 588 0 0 369 0 0 0 84 85 123 123 123 123 123 123 123 123 123 123 123 123 123 123 123 123 123 123 123 123 123 84 85 0 0 0 0 0 0 0 0 0 0 0 0 0 0 0 0 0 0 0 0 0 0 0
0 0 4 4 0 0 0 0 0 0 0 0 371 0 0 0 84 85 123 123 123 123 123 123 123 123 123 123 123 123 123 123 123 123 123 123 123 123 123 84 85 0 0 0 0 0 0 0 0 0 0 0 718 0 0 0 0 0 0 0 0 0 0 0
0 0 0 0 0 0 6 0 0 292 293 294 365 0 0 0 84 85 123 123 123 123 123 123 123 123 123 123 123 123 123 123 123 123 123 123 123 123 123 84 85 0 0 0 0 0 0 0 0 0 0 0 0 0 0 0 0 0 0 0 0 0 0 0
0 0 0 0 0 0 0 0 0 295 296 297 369 0 0 0 84 85 123 123 123 123 123 123 123 123 123 123 123 123 123 123 123 123 123 123 123 123 123 84 85 0 0 720 0 0 0 0 0 0 0 0 0 600 0 684 686 0 0 0 0 0 0 0
0 0 0 0 0 0 0 0 0 298 299 300 0 0 0 0 84 85 123 123 123 123 123 123 123 123 123 123 123 123 123 123 123 123 123 123 123 123 123 84 85 0 0 722 0 0 0 0 0 0 0 0 0 0 0 688 690 0 0 0 0 0 0 0
0 580 582 0 0 0 0 0 0 0 0 0 0 0 0 0 84 67 61 61 61 61 61 61 61 61 61 61 61 61 61 61 61 61 61 61 61 61 61 66 85 0 0 0 0 0 0 0 0 0 0 0 0 0 0 0 0 0 0 0 0 0 0 0
0 584 586 0 0 0 0 0 0 0 0 0 0 0 622 0 107 108 108 108 108 108 108 108 108 108 108 108 108 108 108 108 108 108 108 108 108 108 108 108 109 0 0 0 0 0 0 0 0 0 0 614 0 0 0 0 0 0 0 0 0 0 0 0
0 0 0 0 0 4 0 0 0 9 10 11 0 0 0 0 91 92 92 92 94 95 92 92 92 45 97 105 105 98 92 92 92 92 94 95 92 92 92 92 93 0 0 0 0 0 0 0 0 0 0 0 0 0 0 0 0 0 0 0 0 0 0 0
0 0 0 718 0 3 5 0 0 0 0 0 0 0 0 0 115 116 116 116 118 119 116 116 116 116 121 189 189 122 116 116 116 116 118 119 116 116 116 116 117 0 0 0 0 708 710 0 0 0 0 0 0 0 0 0 0 0 0 720 0 0 0 0
0 0 0 0 0 0 0 0 0 0 0 0 0 0 373 374 0 0 0 0 0 0 0 0 352 353 354 127 128 358 359 360 0 0 0 0 0 0 0 0 0 0 0 0 0 712 714 0 0 0 0 0 0 0 0 0 0 0 0 722 0 0 0 0
0 0 0 0 0 4 0 0 0 0 0 720 0 0 375 376 0 0 604 0 0 0 334 0 355 356 307 126 127 0 362 363 0 0 590 0 0 0 0 0 0 0 0 0 0 0 0 0 0 0 0 0 0 0 718 0 0 0 0 0 0 0 0 0
0 0 0 564 0 5 258 259 0 0 0 722 0 0 377 378 0 0 304 328 328 328 328 318 316 328 315 124 123 307 4 0 0 0 0 0 0 0 0 0 0 0 0 0 0 0 0 0 0 0 0 0 0 0 0 0 0 612 0 0 0 0 0 0
0 0 0 0 0 0 260 261 0 0 0 0 0 0 379 380 0 0 123 123 127 128 123 123 124 123 128 123 127 0 0 341 0 0 0 0 0 0 720 0 0 600 0 0 0 0 0 0 0 0 0 0 0 0 0 0 0 0 0 0 0 0 0 0
0 0 0 0 0 0 0 0 0 0 0 0 0 0 0 0 0 0 123 125 123 123 124 123 123 125 123 123 123 326 0 0 0 0 0 0 0 0 722 0 0 0 0 0 0 0 0 0 0 0 0 0 0 0 0 0 0 0 616 0 0 0 0 0
0 0 0 0 0 0 0 0 0 0 0 0 0 0 0 0 0 0 304 328 328 317 328 328 328 318 316 317 328 315 0 0 0 342 0 0 0 0 0 0 0 0 0 0 0 0 0 0 0 0 0 0 0 0 0 0 0 0 0 0 0 0 0 0