17 13
181 181 181 181 181 181 181 181 181 181 181 181 181 181 181 181 181
181 181 181 181 181 181 181 181 181 181 181 181 181 181 181 181 181
113 113 113 113 113 113 113 113 113 113 113 113 113 113 113 113 113
113 113 113 113 113 113 113 113 113 113 113 113 113 113 113 113 113
113 113 113 113 113 113 113 113 113 113 113 113 113 113 113 113 113
113 113 113 113 113 113 113 113 113 113 113 113 113 113 113 113 113
96 96 96 96 96 96 96 96 96 96 96 96 96 96 96 96 96
96 96 96 96 96 96 96 96 96 96 96 96 98 96 96 96 96
98 96 96 96 96 96 96 98 96 96 98 96 98 96 96 96 96
96 98 98 96 96 96 98 96 98 96 98 96 96 98 98 98 98
96 96 96 96 96 96 98 96 96 98 98 98 98 98 98 96 96
98 96 98 98 98 98 96 98 98 96 96 96 96 96 98 98 96
96 96 98 98 96 96 96 96 98 98 96 96 96 96 96 98 96