48 24
2 3 4 5 6 3 4 5 6 7 3 4 5 6 3 4 5 6 3 4 5 6 3 4 5 6 3 4 5 6 3 4 5 6 3 4 5 6 3 4 5 6 3 4 5 6 4 7
8 9 10 11 12 9 10 11 12 12 9 10 11 12 9 10 11 12 9 10 11 12 9 10 11 12 9 10 11 12 9 10 11 12 9 10 11 12 9 10 11 12 9 10 11 12 10 13
14 15 16 17 18 15 16 17 18 18 15 16 17 18 15 16 17 18 15 16 17 18 15 16 17 18 15 16 17 18 15 16 17 18 15 16 17 18 15 16 17 18 15 16 17 18 16 19
20 21 22 23 24 21 22 23 24 21 22 23 24 21 22 23 24 21 22 23 24 21 22 23 24 21 22 23 24 21 22 23 24 21 22 23 24 21 22 23 24 21 22 23 24 21 21 25
31 0 1 192 240 240 240 194 110 94 0 0 0 0 0 0 1 0 0 0 0 0 0 1 0 0 0 0 0 1 0 1 1 0 0 0 1 0 0 0 216 217 0 0 1 1 0 0
201 27 27 77 240 30 240 240 240 240 240 240 240 194 1 0 1 0 0 0 0 100 101 204 27 205 0 0 0 0 0 0 1 1 1 1 1 59 208 209 218 219 224 225 0 1 0 0
33 33 207 197 240 240 240 199 1 1 1 1 0 197 240 240 240 240 240 240 240 240 240 199 206 207 0 0 0 0 0 0 0 0 0 0 0 1 210 211 220 221 226 227 1 1 0 0
0 0 88 0 0 0 1 1 1 1 1 106 107 1 0 1 51 52 0 0 0 0 1 0 0 0 0 0 0 0 0 0 0 0 0 0 1 0 212 213 222 223 228 229 1 1 1 0
0 0 89 0 0 0 0 1 1 1 1 1 1 1 1 1 55 56 0 1 1 1 111 0 0 0 1 0 0 0 0 0 0 0 0 0 113 0 214 215 236 237 230 231 1 0 0 0
0 0 0 0 0 0 1 0 0 1 1 0 0 1 1 1 0 1 0 0 1 0 1 1 1 0 1 0 0 0 0 0 0 0 0 0 1 1 1 1 238 239 0 0 0 0 0 0
144 145 146 147 0 0 1 0 1 1 0 0 0 0 1 1 1 0 1 1 1 0 1 0 0 0 1 0 0 0 0 0 0 0 0 0 0 1 1 64 0 0 95 0 1 1 1 1
148 149 150 151 0 0 1 0 1 93 1 1 1 1 1 64 1 1 1 1 0 1 1 0 0 0 1 86 0 0 0 0 0 0 0 0 0 1 1 0 0 0 0 0 0 0 0 0
0 152 153 0 0 0 0 1 0 1 0 0 0 113 0 1 0 1 0 0 0 0 1 1 0 0 0 87 0 0 0 0 0 0 0 0 0 1 0 0 0 0 0 61 0 0 0 0
1 154 155 0 0 0 1 1 1 1 1 1 0 0 1 66 67 1 1 0 0 1 1 37 38 0 1 1 0 0 0 0 0 0 0 0 0 0 0 0 0 0 0 0 0 0 0 0
0 0 0 0 0 1 0 1 208 209 1 1 0 0 1 1 1 1 1 1 1 0 1 41 42 0 1 1 0 232 233 0 0 0 0 0 0 1 0 0 0 0 0 0 0 0 0 0
0 0 0 0 0 1 86 1 210 211 1 1 0 1 1 0 0 0 1 0 0 1 0 1 1 0 112 0 0 234 235 0 0 0 0 0 0 0 0 0 0 0 0 114 0 0 0 0
0 0 0 0 0 1 87 1 212 213 1 1 1 1 80 0 0 0 0 1 0 1 0 1 0 0 0 0 0 0 0 0 0 0 0 0 0 1 0 236 237 0 0 0 0 0 0 0
27 27 27 27 27 28 0 1 214 215 1 1 1 0 81 0 0 0 1 1 0 1 1 0 0 0 0 0 0 0 0 0 114 0 0 0 0 0 0 238 239 0 0 0 0 0 0 0
240 240 240 240 241 31 1 0 0 0 1 1 1 1 1 1 1 1 0 1 1 82 0 0 0 0 0 0 0 0 0 0 0 0 0 0 0 0 1 0 0 0 132 133 134 135 0 0
33 33 33 202 241 31 1 1 1 1 1 1 1 1 1 1 0 1 0 1 0 83 0 0 0 0 0 0 0 0 0 0 0 0 0 1 1 1 1 1 1 0 136 137 138 139 0 0
0 0 0 29 241 31 1 1 1 0 94 0 0 0 1 0 0 1 1 1 0 0 0 0 0 0 61 0 0 0 0 106 107 1 1 0 0 0 0 1 0 1 1 140 141 0 0 0
0 0 0 29 241 31 1 0 1 97 0 0 0 1 1 0 1 0 1 0 0 0 0 0 0 0 0 0 0 0 0 0 0 1 1 242 0 0 0 0 1 0 0 142 143 0 0 0
0 0 0 29 241 31 1 1 96 1 0 1 1 1 1 68 69 69 69 70 0 0 0 0 0 0 0 0 0 0 0 0 0 0 0 0 0 1 1 1 1 1 1 1 1 1 1 1
0 0 0 29 241 31 1 1 1 0 1 0 0 0 0 71 72 72 72 73 0 0 0 0 0 0 0 0 0 0 0 0 0 0 0 0 0 0 0 0 0 0 0 0 0 0 0 0