24 24
43 43 43 43 43 43 43 43 43 43 43 43 43 43 43 43 43 43 43 43 43 43 43 43
43 62 62 62 62 62 62 62 62 62 62 62 62 62 62 62 62 62 62 62 62 62 62 43
43 62 62 62 62 62 62 62 62 62 62 62 62 62 62 62 62 62 62 62 62 62 62 43
43 62 62 125 125 125 125 125 125 125 125 125 125 125 125 125 125 125 125 125 125 62 62 43
43 62 62 125 125 125 125 125 125 125 125 125 125 125 125 125 125 125 125 125 125 62 62 43
43 62 62 125 125 125 125 125 125 125 125 125 125 125 125 125 125 125 125 125 125 62 62 43
43 62 62 125 125 125 125 125 125 125 125 125 125 125 125 125 125 125 125 125 125 62 62 43
43 62 62 125 125 125 125 125 125 125 125 125 125 125 125 125 125 125 125 125 125 62 62 43
43 62 62 125 125 125 125 125 125 125 125 125 125 125 125 125 125 125 125 125 125 62 62 43
43 62 62 125 125 125 125 125 125 125 125 125 125 125 125 125 125 125 125 125 125 62 62 43
43 62 62 125 125 125 125 125 125 125 125 125 125 125 125 125 125 125 125 125 125 62 62 43
43 62 62 125 125 125 125 125 125 125 125 125 125 125 125 125 125 125 125 125 125 62 62 43
43 62 62 125 125 125 125 125 125 125 125 125 125 125 125 125 125 125 125 125 125 62 62 43
43 62 62 125 125 125 125 125 125 125 125 125 125 125 125 125 125 125 125 125 125 62 62 43
43 62 62 125 125 125 125 125 125 125 125 125 125 125 125 125 125 125 125 125 125 62 62 43
43 62 62 125 125 125 125 125 125 125 125 125 125 125 125 125 125 125 125 125 125 62 62 43
43 62 62 125 125 125 125 125 125 125 125 125 125 125 125 125 125 125 125 125 125 62 62 43
43 62 62 125 125 125 125 125 125 125 125 125 125 125 125 125 125 125 125 125 125 62 62 43
43 62 62 125 125 125 125 125 125 125 125 125 125 125 125 125 125 125 125 125 125 62 62 43
43 62 62 125 125 125 125 125 125 125 125 125 125 125 125 125 125 125 125 125 125 62 62 43
43 62 62 125 125 125 125 125 125 125 125 125 125 125 125 125 125 125 125 125 125 62 62 43
43 62 62 62 62 62 62 62 62 62 62 62 62 62 62 62 62 62 62 62 62 62 62 43
43 62 62 62 62 62 62 62 62 62 62 62 62 62 62 62 62 62 62 62 62 62 62 43
43 43 43 43 43 43 43 43 43 43 43 43 43 43 43 43 43 43 43 43 43 43 43 43