64 48
1 1 1 1 1 1 1 1 1 60 61 0 65 59 1 1 1 1 1 1 1 1 1 1 1 1 1 462 463 463 462 1 1 1 1 1 2 3 3 3 3 3 3 3 3 3 3 3 3 3 3 3 3 3 3 3 3 3 3 3 3 3 4 1
1 1 2 3 3 3 3 3 3 168 61 0 65 90 3 3 3 3 4 1 1 1 1 1 1 1 1 493 494 494 495 1 1 1 1 31 32 33 33 33 33 33 33 33 33 33 33 33 33 33 33 33 33 33 33 33 33 33 33 33 33 33 34 35
1 31 32 33 33 33 33 33 33 33 0 0 691 33 33 33 33 33 34 388 3 4 1 1 1 1 1 524 525 525 526 1 1 1 1 29 80 0 0 0 0 0 0 0 0 0 0 0 0 0 0 0 0 0 0 0 0 0 0 0 0 0 65 59
1 62 41 0 0 0 0 0 0 0 0 0 0 0 0 0 0 0 191 33 33 34 35 1 1 1 1 555 556 556 557 1 1 1 1 31 80 0 898 899 0 0 0 0 0 0 0 0 0 0 0 0 0 0 0 0 0 0 0 0 0 0 65 59
1 93 41 0 0 890 0 0 0 365 366 366 366 367 0 0 0 0 0 0 0 58 66 1 1 1 1 586 587 587 588 1 1 1 1 29 80 0 0 0 0 0 0 0 0 0 0 0 0 0 0 0 0 0 0 0 0 0 0 0 0 0 65 59
1 93 41 0 0 0 0 0 0 396 452 312 703 398 0 0 0 0 0 0 0 89 90 3 3 3 3 3 3 3 3 3 3 3 3 91 92 0 0 0 0 0 0 0 0 0 0 0 0 0 0 0 0 0 0 0 0 0 0 0 0 0 65 59
1 62 41 0 0 0 0 0 0 396 282 126 280 398 0 0 0 0 0 0 0 0 33 33 33 33 33 33 33 33 33 33 33 33 33 33 200 0 0 0 0 0 0 0 0 0 0 0 0 0 0 0 0 0 0 0 0 0 0 0 0 0 65 59
1 93 41 0 0 0 0 0 0 396 282 157 280 398 0 0 0 0 0 0 0 0 0 0 0 0 0 0 0 0 0 0 0 0 0 0 0 0 0 0 0 0 0 0 0 0 0 0 0 0 0 0 0 0 0 0 0 0 0 0 0 0 65 59
1 93 41 0 0 0 0 0 0 396 282 130 280 398 0 0 0 0 0 0 0 0 0 0 0 0 0 0 0 0 0 0 0 0 0 0 0 0 0 0 0 0 0 0 0 0 0 0 0 0 0 0 0 0 0 0 0 0 0 0 0 0 65 59
1 93 41 0 0 0 0 0 0 396 282 130 280 398 0 0 0 0 0 0 0 0 0 0 0 0 0 0 0 0 0 0 0 0 0 0 0 0 0 0 0 0 0 0 0 0 0 0 0 0 0 0 0 0 0 0 0 0 0 0 0 0 65 59
1 62 41 0 0 0 0 0 0 396 282 130 280 398 0 0 0 0 0 0 0 0 0 0 0 0 0 0 0 0 0 0 0 0 0 0 0 0 0 0 0 0 0 0 0 0 0 0 0 0 0 0 0 0 0 0 0 869 870 0 0 0 65 59
1 93 41 0 0 0 0 0 0 396 282 130 280 398 0 0 0 0 0 0 0 0 0 0 0 0 0 0 0 0 0 0 0 0 0 0 0 0 0 0 0 0 0 0 0 0 0 0 0 0 0 0 0 0 0 0 0 871 872 0 0 0 65 59
1 62 41 0 0 0 0 0 0 396 282 658 280 398 0 0 0 0 0 0 23 95 95 95 95 95 95 95 95 95 95 95 95 95 95 95 95 6 0 0 0 0 0 0 0 0 0 0 0 0 0 0 0 0 0 0 0 0 0 0 0 0 65 59
1 93 41 0 0 0 0 0 0 396 337 623 340 398 0 0 0 0 890 0 65 43 43 126 126 126 126 126 126 126 126 126 126 126 126 126 44 63 0 0 0 0 0 0 0 0 0 0 0 0 0 0 0 0 0 0 0 0 0 0 0 0 65 59
1 93 41 0 0 0 0 0 0 427 428 428 428 429 0 0 0 0 0 0 65 55 157 157 157 157 157 157 157 157 157 157 157 157 157 157 75 94 26 0 0 0 0 0 0 0 0 0 0 0 0 0 0 0 0 0 0 0 0 0 0 0 65 59
1 29 63 0 0 0 0 0 0 0 0 0 0 0 0 0 0 0 0 0 65 59 1 1 1 1 1 1 1 1 1 1 1 1 1 1 124 125 94 26 0 0 0 0 0 0 0 0 0 0 0 0 0 0 0 0 0 0 0 0 0 0 65 59
1 62 107 26 0 0 0 0 0 0 0 0 0 0 0 0 0 0 0 0 65 59 1 1 1 1 1 1 1 1 1 1 1 1 1 1 155 156 103 63 0 0 0 0 0 0 0 894 0 0 0 0 0 0 0 0 0 0 0 0 0 0 65 59
1 124 125 99 0 0 0 0 0 0 0 0 0 0 0 0 0 0 0 0 65 59 1 1 1 1 1 1 1 1 851 852 853 854 1 1 1 31 44 99 0 0 0 0 0 0 0 895 0 0 0 0 0 0 0 0 0 0 0 0 0 0 65 59
1 155 84 63 0 0 0 0 0 0 0 0 0 0 0 0 0 0 0 0 65 59 1 1 1 1 1 1 1 1 855 856 857 858 1 1 1 1 48 99 0 0 0 0 0 0 0 0 0 0 0 0 0 0 0 0 0 0 0 0 0 0 65 59
1 1 315 131 0 0 0 0 0 0 0 0 0 0 0 0 0 0 0 0 65 59 1 1 1 1 1 218 219 220 1 1 1 1 1 1 1 1 29 94 95 95 95 95 22 0 0 0 0 0 0 0 0 0 0 0 0 0 0 0 0 0 65 59
1 1 62 131 0 880 0 0 0 0 0 0 0 0 0 0 0 0 0 881 65 176 1 1 1 1 248 249 250 251 252 1 1 1 1 1 1 1 29 103 126 126 126 126 94 95 95 95 95 95 95 95 95 95 95 95 95 95 95 95 95 95 96 97
1 1 124 131 0 0 0 0 0 0 0 0 0 0 0 0 0 0 0 0 65 593 1 1 1 1 246 254 281 255 245 1 1 1 1 1 1 1 527 88 374 374 374 520 342 126 126 126 126 126 126 126 126 126 126 126 126 126 126 126 126 104 104 105
1 1 124 131 0 0 0 0 0 0 0 0 0 0 0 0 0 0 0 0 201 34 35 1 1 1 246 258 281 255 245 1 1 1 1 1 1 1 1 118 118 118 118 535 373 157 157 157 157 157 157 157 157 157 157 157 157 157 157 157 157 157 158 159
1 1 124 131 883 884 0 0 0 0 0 0 0 0 0 0 0 0 0 0 0 65 593 1 1 1 246 254 281 259 245 1 1 1 1 1 1 1 1 1 1 1 1 1 1 1 1 1 1 1 1 1 1 1 1 1 1 1 1 1 1 1 1 1
1 2 91 131 885 886 0 0 0 0 0 0 0 0 0 0 0 0 0 0 880 691 34 593 1 1 246 262 281 259 245 1 1 1 1 1 1 1 1 1 1 1 1 1 1 1 1 1 1 1 1 1 1 1 1 1 1 1 1 1 1 1 1 1
1 32 33 194 0 0 0 0 0 0 0 0 0 0 0 0 0 0 0 0 0 0 691 34 35 1 246 254 281 263 245 1 1 2 3 3 3 3 3 3 3 3 3 3 3 3 3 3 3 3 3 3 3 3 3 3 3 3 3 4 1 1 1 1
93 41 0 0 0 0 0 0 0 0 0 0 0 0 0 0 0 0 0 0 0 0 0 65 1 1 246 266 281 263 245 1 1 32 33 33 33 33 33 33 33 33 33 33 33 33 33 33 33 33 33 33 33 33 33 33 33 33 33 34 35 1 1 1
93 41 0 0 0 0 0 0 0 0 0 0 0 0 0 0 0 0 0 0 0 0 0 65 90 3 91 266 281 267 90 3 91 41 0 0 0 0 0 0 0 0 0 0 0 0 0 0 0 0 0 0 0 0 0 0 0 0 0 65 66 1 1 1
62 41 0 0 0 0 0 0 0 0 0 0 0 0 0 0 0 0 0 0 0 0 0 0 0 365 416 410 281 415 419 367 33 194 893 0 0 0 0 0 0 0 0 0 0 0 0 0 0 0 0 0 0 0 0 0 0 897 0 65 66 1 1 1
93 41 0 881 0 0 0 0 0 0 0 0 0 0 0 0 0 0 0 0 0 0 0 0 0 427 428 428 428 428 428 429 0 0 0 0 0 0 0 0 0 883 884 0 0 0 0 0 0 0 0 0 0 0 0 0 0 0 0 65 66 1 1 1
93 41 0 0 0 0 0 0 0 0 0 0 0 0 0 0 0 0 0 0 0 0 0 0 0 0 0 0 0 0 0 0 0 0 0 0 0 0 0 0 885 886 0 0 0 0 0 0 0 0 0 0 0 0 0 0 0 0 0 65 66 1 1 1
93 41 0 0 0 0 0 0 0 0 0 0 0 0 0 0 0 0 0 0 0 0 0 0 0 0 0 0 0 0 0 0 0 0 0 0 0 0 891 0 0 0 0 0 0 0 0 0 0 0 0 0 0 0 0 0 0 0 0 65 66 1 1 1
93 41 0 0 0 0 0 0 0 0 0 0 0 0 0 0 0 0 0 0 0 0 0 0 0 0 0 0 0 0 0 0 0 0 0 0 0 0 0 0 0 0 0 0 0 0 0 0 0 0 0 0 0 0 0 0 0 0 0 65 66 1 1 1
62 41 0 0 0 0 0 0 0 0 0 0 0 0 0 0 0 0 0 0 0 0 0 0 0 0 0 0 0 0 0 0 0 0 0 890 0 0 0 0 0 0 0 0 0 0 0 0 0 0 0 0 0 0 0 0 0 0 0 65 66 1 1 1
93 41 0 0 0 0 0 0 0 0 0 0 0 0 0 0 0 23 95 95 95 95 95 95 95 22 0 0 0 0 0 0 0 0 0 0 0 0 0 0 0 0 0 0 0 0 0 0 0 0 0 0 0 0 0 0 0 0 0 65 66 1 1 1
93 41 0 0 0 0 0 0 0 0 0 0 0 0 0 0 0 65 39 126 126 126 126 126 40 63 0 0 0 0 0 0 0 0 0 0 0 0 0 0 0 0 0 0 0 0 0 0 0 0 0 897 0 0 0 0 0 0 0 65 66 1 1 1
93 41 0 0 0 0 0 0 0 0 0 0 0 0 0 0 0 65 51 157 157 157 157 157 48 63 0 0 0 0 0 0 0 0 0 0 0 0 0 0 0 0 0 0 0 0 0 0 0 0 0 0 0 0 0 0 0 0 0 65 66 1 1 1
62 41 0 0 0 0 0 0 0 0 0 0 0 0 0 0 0 65 499 205 205 205 205 205 496 63 0 0 0 0 0 0 0 0 0 0 0 0 0 0 0 0 0 0 0 0 0 0 0 0 0 0 0 0 0 0 0 896 0 65 66 1 1 1
62 41 0 0 0 0 0 0 0 0 0 0 0 0 0 0 0 686 33 33 33 33 33 33 33 200 0 0 0 0 0 0 0 0 0 888 889 0 0 0 0 0 0 0 0 0 0 0 0 0 0 0 0 0 0 0 0 0 896 65 66 1 1 1
93 80 0 0 0 0 0 0 0 0 887 0 0 0 0 0 0 0 0 0 0 0 0 0 0 0 0 0 0 890 0 0 0 0 0 0 0 0 0 0 0 0 0 0 0 0 0 0 0 0 0 0 887 0 0 0 0 0 0 65 66 1 1 1
93 63 0 0 0 0 0 0 0 0 0 0 0 0 0 0 0 0 0 0 0 0 0 0 0 0 0 0 0 0 0 0 0 0 0 0 0 0 0 0 0 0 0 0 0 0 0 0 0 0 0 0 0 888 889 0 0 899 0 65 66 1 1 1
93 63 0 0 0 0 0 0 0 0 0 0 0 0 0 0 0 0 0 0 0 0 0 0 0 0 0 0 0 0 0 0 0 0 0 0 0 0 0 0 0 0 0 0 0 0 0 0 0 0 0 0 0 0 0 0 0 64 0 65 113 1 1 1
93 63 0 0 0 0 0 0 0 0 0 0 0 0 0 0 0 0 0 0 0 0 0 0 0 0 0 0 0 0 0 0 0 0 0 0 0 0 0 0 0 0 0 0 0 0 0 0 0 0 0 0 0 0 0 0 0 0 0 65 113 1 1 1
62 63 0 0 0 0 0 0 0 0 0 0 0 0 0 0 0 0 0 0 0 0 0 0 0 0 0 0 0 0 0 0 0 0 0 0 0 0 0 0 0 0 0 0 0 0 0 0 0 0 0 0 0 0 0 0 887 0 0 65 113 1 1 1
93 80 0 887 0 0 0 0 0 0 0 0 0 0 0 0 0 0 0 0 0 0 0 0 0 0 0 0 0 0 0 0 0 0 0 0 0 0 0 0 0 0 0 0 0 0 0 0 0 0 0 0 0 0 0 0 0 0 23 56 113 1 1 1
124 94 95 95 95 5 21 5 5 5 5 5 21 5 5 5 5 5 5 21 5 5 20 20 21 24 8 8 8 13 24 21 20 20 20 20 20 20 20 20 20 21 21 21 5 5 5 5 5 5 5 5 5 5 5 5 5 5 54 502 113 1 1 1
124 125 126 126 126 126 126 126 126 126 126 126 126 126 126 126 126 126 126 126 126 126 126 126 126 126 126 126 126 126 126 126 126 126 126 126 126 126 126 126 126 126 126 126 126 126 126 126 126 126 126 126 126 126 126 126 126 126 127 539 159 1 1 1
155 156 157 157 157 157 157 157 157 157 157 157 157 157 157 157 157 157 157 157 157 157 157 157 157 157 157 157 157 157 157 157 157 157 157 157 157 157 157 157 157 157 157 157 157 157 157 157 157 157 157 157 157 157 157 157 157 157 158 159 1 1 1 1