48 48
10 14 10 10 10 10 10 10 10 10 10 10 10 17 17 17 10 10 10 10 10 10 10 10 10 10 10 10 10 10 10 10 10 10 10 10 10 10 10 10 10 10 10 10 10 10 10 10
10 14 14 14 10 10 10 10 10 10 10 10 29 17 13 17 17 17 10 10 10 10 10 10 10 10 10 10 10 10 10 10 10 10 10 6 6 6 6 6 6 10 10 10 10 10 10 10
10 14 14 14 10 10 10 10 10 10 10 17 17 6 6 13 13 30 17 10 10 10 10 10 10 10 10 10 10 10 10 10 10 10 6 6 6 6 6 6 10 10 10 10 10 10 10 10
10 10 14 14 10 10 10 10 10 10 17 17 6 6 6 6 13 17 17 10 10 10 10 10 10 10 10 10 10 10 10 10 10 10 6 6 6 6 6 6 10 10 10 10 10 10 10 10
10 10 10 10 10 10 10 10 10 17 17 6 6 6 6 6 6 13 17 10 10 10 10 10 10 10 10 10 10 10 10 10 10 10 10 6 6 6 10 10 10 10 10 10 10 10 10 10
10 10 10 10 10 10 10 10 10 31 17 6 6 12 6 6 6 17 17 10 10 10 10 10 10 10 10 10 10 10 10 10 10 10 10 6 6 10 10 10 10 10 10 10 10 10 10 10
10 10 10 10 10 10 10 10 10 10 17 17 6 6 6 6 13 17 10 10 10 10 10 10 10 10 10 10 10 10 10 10 10 10 10 10 10 10 10 10 10 10 10 10 10 10 10 10
10 10 10 6 6 6 6 6 10 10 17 17 13 6 6 13 17 29 10 10 10 10 10 10 10 10 10 10 10 10 10 10 10 10 10 10 10 10 10 10 10 10 10 10 10 10 10 10
10 10 6 6 6 6 6 14 6 10 17 28 17 6 13 17 17 10 10 10 10 10 10 10 10 10 10 10 10 10 10 10 10 10 10 10 10 10 10 10 10 10 10 10 10 10 10 10
6 6 6 6 6 14 14 15 15 6 10 10 17 17 17 10 10 10 10 10 10 10 10 10 10 10 10 10 10 10 19 19 19 10 10 10 10 10 10 10 10 10 10 10 10 10 10 10
6 6 14 14 14 15 15 15 15 6 10 10 10 10 10 10 10 10 10 10 10 10 14 14 10 10 10 10 19 19 7 18 19 19 10 10 10 10 10 10 10 10 10 10 10 10 10 10
15 15 15 15 25 15 15 15 6 6 10 10 10 10 10 10 10 10 10 14 14 14 14 14 10 10 10 10 19 18 18 18 18 19 19 10 10 10 10 10 10 10 10 10 10 10 10 10
15 15 15 25 25 15 15 6 6 6 10 10 10 10 10 10 10 10 10 14 14 14 14 14 10 10 10 10 19 7 18 18 18 18 19 19 10 10 10 10 10 10 10 10 10 10 10 10
15 15 15 25 25 15 14 6 6 10 10 10 10 10 10 10 10 10 10 14 14 14 14 10 10 10 10 10 19 19 7 18 18 18 7 19 10 10 10 10 10 10 10 10 10 10 10 10
15 15 25 25 25 15 14 6 6 6 10 10 10 10 10 10 10 10 10 14 14 14 14 10 10 10 10 10 10 19 18 18 7 18 18 19 9 10 10 10 10 10 10 10 10 10 10 10
14 15 25 25 15 14 14 20 20 6 10 10 10 10 10 10 10 10 10 10 14 14 10 10 10 10 10 10 10 19 19 18 18 18 18 9 9 9 9 10 10 10 10 10 10 10 10 10
14 15 15 15 14 14 20 20 6 6 6 6 6 6 10 10 10 10 10 10 10 10 10 10 10 10 10 10 10 10 19 19 7 18 9 9 9 8 9 9 9 10 10 10 10 10 10 10
14 14 14 14 20 20 19 19 19 19 19 19 19 6 6 10 10 10 10 10 10 10 10 10 10 10 10 10 10 10 10 19 18 9 9 8 8 8 8 8 9 9 10 10 10 10 10 10
14 14 6 20 20 19 19 19 18 18 18 18 18 19 6 6 10 10 10 10 10 19 19 19 19 19 10 10 10 10 10 10 9 9 8 8 8 8 8 8 8 9 9 10 10 10 10 10
6 6 6 20 19 18 18 18 18 18 18 18 18 19 19 6 6 10 10 10 19 19 17 31 17 19 19 19 10 10 10 10 9 8 8 8 8 8 8 8 8 8 9 10 10 10 10 10
6 6 19 20 18 18 18 18 18 18 18 18 18 18 19 6 10 10 10 10 19 17 17 17 17 17 17 19 19 10 10 10 9 9 8 8 8 8 8 8 8 9 9 10 10 10 10 10
6 6 19 19 18 18 18 18 18 18 18 19 19 19 6 6 10 10 6 6 6 21 21 21 21 21 17 19 19 19 10 10 10 9 9 9 9 9 8 8 9 9 10 10 10 10 10 10
6 6 19 18 18 18 18 18 19 19 19 19 19 6 6 10 10 6 21 21 21 21 21 21 21 21 17 17 17 19 10 10 10 19 19 7 18 9 9 9 9 10 10 10 10 10 10 10
6 19 19 18 18 18 19 19 19 19 6 19 6 6 10 10 10 6 21 21 21 21 21 21 21 21 21 21 17 19 10 19 19 19 18 18 7 18 19 9 10 10 10 10 10 10 10 10
6 19 19 18 18 18 19 19 19 6 6 6 6 10 10 10 6 6 21 21 21 21 21 21 21 21 21 21 17 19 19 18 18 7 18 18 18 19 19 10 10 10 10 10 10 10 10 10
6 19 19 19 18 18 19 19 6 6 10 10 6 10 10 10 6 21 21 21 21 21 21 21 23 23 21 21 17 19 18 18 18 18 18 19 19 19 10 10 10 10 10 10 10 10 10 10
6 19 19 19 18 18 19 19 6 10 10 10 10 10 10 10 6 17 17 17 17 17 21 21 21 21 21 21 29 19 7 7 18 19 19 19 10 10 10 10 10 10 10 10 10 10 10 10
6 6 19 19 19 19 19 6 10 10 10 10 10 10 10 10 10 19 19 19 17 17 17 17 17 17 21 21 17 19 18 19 19 19 10 10 10 10 10 10 10 10 10 10 10 10 10 10
10 6 6 6 6 6 6 6 10 10 10 10 10 10 10 10 10 10 19 19 17 27 17 17 17 17 21 21 21 17 19 19 10 10 10 10 10 10 10 10 10 10 10 10 10 10 10 10
10 10 10 10 10 10 10 10 10 10 10 10 10 10 10 10 10 10 10 19 19 17 17 17 29 17 17 21 21 20 17 19 19 19 19 10 10 10 10 10 10 10 10 10 10 10 10 10
10 10 6 6 6 10 10 10 10 10 10 10 10 10 10 10 10 10 10 10 19 17 17 17 17 17 17 21 21 21 20 17 17 19 19 19 10 10 10 10 10 10 10 10 10 10 10 10
10 10 6 6 6 6 10 10 10 10 10 10 10 10 10 10 10 10 10 10 19 19 17 17 17 19 19 19 17 21 21 20 20 17 17 19 19 19 10 10 10 10 10 10 10 10 10 10
10 6 6 10 10 10 6 6 10 10 10 10 10 10 10 10 10 10 10 10 19 19 19 17 17 19 10 19 19 17 20 20 20 20 20 17 17 19 19 19 10 10 10 10 10 10 10 10
10 6 6 10 10 6 6 6 10 10 10 10 10 10 10 10 10 10 10 10 10 10 19 19 19 19 10 10 19 19 17 20 20 20 20 20 20 17 17 19 19 10 10 10 10 10 10 10
10 10 6 6 6 6 6 6 10 10 10 10 10 10 10 10 10 10 10 10 10 10 10 10 10 10 10 10 33 19 19 17 20 20 20 20 20 20 17 17 19 10 10 10 10 10 10 10
10 10 6 6 6 10 10 10 10 10 10 10 10 10 10 10 10 10 10 10 10 10 10 10 10 10 10 10 10 19 19 17 17 20 20 20 20 20 20 17 19 10 10 10 10 10 10 10
10 10 10 10 10 10 10 10 10 10 10 10 10 10 10 10 10 10 6 6 10 10 10 10 10 10 10 10 10 10 10 19 17 17 17 17 17 17 17 17 19 10 10 10 10 10 10 10
10 10 10 10 10 10 10 10 10 10 10 10 10 10 10 10 10 6 6 6 6 6 6 6 6 10 10 10 10 10 10 19 19 19 19 19 19 19 17 17 19 10 10 10 10 10 10 10
10 10 10 10 10 10 10 10 10 10 10 10 10 10 10 10 6 6 6 6 14 14 14 14 6 6 6 10 10 10 10 10 10 10 10 10 10 19 19 19 10 10 10 10 10 10 10 10
10 10 10 10 10 10 10 10 10 10 10 10 10 10 6 6 14 14 14 14 14 14 14 14 14 14 14 6 6 10 10 10 10 10 10 10 10 10 10 10 10 10 10 10 10 10 10 10
10 10 10 10 10 10 10 10 10 10 10 6 6 6 6 6 14 14 14 17 17 17 17 17 14 14 14 14 6 6 6 10 10 10 10 10 10 10 10 10 10 10 10 10 10 10 10 10
10 10 10 10 10 10 10 10 10 10 10 6 6 6 6 14 14 14 17 31 17 17 17 17 14 14 14 14 14 14 6 6 6 6 10 10 10 10 10 10 10 10 10 10 10 10 10 10
10 10 10 10 14 14 10 10 10 10 6 6 6 6 14 14 17 17 17 17 17 29 17 17 17 17 17 17 14 14 14 6 6 6 6 6 10 10 10 10 10 10 10 10 10 10 10 10
10 10 14 14 14 14 14 10 10 10 6 6 6 14 14 14 17 17 17 17 17 17 17 17 17 17 17 17 14 14 14 14 6 6 6 6 10 10 10 10 10 10 10 10 10 10 10 10
10 10 14 10 10 10 14 10 10 6 6 14 14 14 14 14 17 28 17 17 17 17 17 17 17 17 32 17 17 14 14 14 14 6 6 6 6 10 10 10 10 10 10 10 10 10 10 10
10 10 14 10 10 14 14 10 6 6 6 14 14 14 14 17 17 17 17 17 27 17 17 17 17 17 17 17 14 14 14 14 14 6 6 6 6 10 10 10 10 10 10 10 10 10 10 10
10 10 10 14 14 14 14 10 6 6 14 14 17 17 17 17 27 17 17 17 17 17 31 17 28 17 17 17 14 14 14 14 14 14 6 6 6 10 10 10 10 10 10 10 10 10 10 10
10 10 10 10 14 14 10 10 6 14 14 17 32 17 27 17 17 17 17 17 17 29 17 17 17 17 32 14 14 14 14 14 14 14 14 14 6 10 10 10 10 10 10 10 10 10 10 10