64 64
3 3 3 3 3 3 3 3 3 3 3 3 3 3 3 3 3 3 3 3 58 22 0 0 0 0 20 46 3 3 3 3 3 3 3 3 3 3 3 3 3 3 3 1 3 3 3 3 3 3 3 3 3 3 3 3 3 3 3 3 3 3 3 3
3 3 3 3 3 3 3 3 3 3 3 3 3 3 3 3 3 3 3 58 22 0 0 0 0 0 0 20 46 3 3 3 3 3 3 3 3 3 3 3 3 3 3 1 3 3 3 3 3 3 3 3 3 3 3 3 3 3 3 3 3 3 3 3
3 3 3 3 3 3 3 3 3 3 3 3 3 3 3 3 3 58 21 22 0 0 0 0 0 0 0 0 20 30 30 30 30 30 30 30 0 3 3 3 3 3 3 3 3 3 3 3 3 3 3 3 3 3 3 3 3 3 3 3 3 3 3 3
3 3 3 3 3 3 3 3 3 3 3 3 3 3 3 3 3 19 0 0 0 0 0 0 0 0 0 0 0 0 0 0 0 0 0 0 0 30 30 30 30 30 30 30 30 30 30 30 30 30 47 3 3 3 3 3 3 3 3 3 3 3 3 3
3 3 3 3 3 3 3 3 3 3 3 3 3 3 3 3 58 22 0 0 0 0 0 0 0 0 0 0 0 0 0 0 0 0 0 0 0 0 0 0 0 0 0 0 0 0 0 0 0 0 0 47 3 3 3 3 3 3 3 3 3 3 3 3
3 3 3 3 3 3 3 3 3 3 3 3 3 3 3 58 22 0 0 0 0 0 0 0 0 0 0 0 0 0 0 0 0 0 0 0 0 0 0 0 0 0 0 0 0 0 0 0 0 0 0 0 47 3 3 3 3 3 3 3 3 3 3 3
3 3 3 3 3 3 3 3 3 58 21 21 21 21 21 22 0 0 0 0 0 0 0 0 0 0 0 0 0 0 0 0 0 0 0 0 0 0 0 0 0 0 0 0 0 0 0 0 0 0 0 0 35 3 3 3 3 3 3 3 3 3 3 3
3 3 3 3 3 3 3 58 21 22 0 0 0 0 0 0 0 0 0 0 0 0 0 0 0 0 0 0 0 0 0 0 0 0 0 0 0 0 0 0 0 0 0 0 0 0 0 0 0 0 0 0 29 47 3 3 3 3 3 3 3 3 3 3
3 3 3 3 3 3 58 22 0 0 0 0 0 0 0 0 0 0 0 0 0 0 0 0 0 0 0 0 0 0 0 0 0 0 0 0 0 0 0 0 0 0 0 0 0 0 0 0 0 0 0 0 0 29 30 47 3 3 3 3 3 3 3 3
3 3 3 3 58 21 22 0 0 0 0 0 0 0 0 0 0 0 0 0 0 0 0 0 0 0 0 0 0 0 0 0 0 0 0 0 0 0 0 0 0 0 0 0 0 0 0 0 0 0 0 0 0 0 0 0 47 3 3 3 3 3 3 3
3 3 3 59 31 0 0 0 0 0 0 0 0 0 0 0 0 0 0 0 0 0 0 0 0 0 0 0 0 0 0 0 0 0 0 0 0 0 0 0 0 0 0 0 0 0 0 0 0 0 0 0 0 0 0 0 0 20 47 3 3 3 3 3
3 3 3 28 0 0 0 0 0 0 0 0 0 0 0 0 0 0 0 0 0 0 0 0 0 0 0 0 0 0 0 0 0 0 0 0 0 0 0 0 0 0 0 0 0 0 0 0 0 0 0 0 0 0 0 0 0 0 0 47 3 3 3 3
3 3 3 28 0 0 0 0 0 0 0 0 0 0 0 0 0 0 0 0 0 0 0 0 0 0 0 0 0 0 0 0 0 0 0 0 0 0 0 0 0 0 0 0 0 0 0 0 0 0 0 0 0 0 0 0 0 0 0 17 3 3 3 3
3 3 3 28 0 0 0 0 0 0 0 0 0 0 0 0 0 0 0 0 0 0 0 0 0 0 0 0 0 0 0 0 0 0 0 0 0 0 0 0 0 0 0 0 0 0 0 0 0 0 0 0 0 0 0 0 0 0 0 17 3 3 3 3
3 3 3 28 0 0 0 0 0 0 0 0 0 0 0 0 0 0 0 0 0 0 0 0 0 0 0 0 0 0 0 0 0 0 0 0 0 0 0 0 0 0 0 0 0 0 0 0 0 0 0 0 0 0 0 0 0 0 0 17 3 3 3 3
3 3 3 28 0 0 0 0 0 0 0 0 0 0 0 0 0 0 0 0 0 0 0 0 0 0 0 0 0 0 0 0 0 0 0 0 0 0 0 0 0 0 0 0 0 0 0 0 0 0 0 0 0 0 0 0 0 0 0 17 3 3 3 3
3 3 3 28 0 0 0 0 0 0 0 0 0 0 0 0 0 0 0 0 0 0 0 0 0 0 0 0 0 0 0 0 0 0 0 0 0 0 0 0 0 0 0 0 0 0 0 0 0 14 15 15 15 15 16 0 0 0 0 17 3 3 3 3
3 3 3 28 0 0 0 0 0 0 0 0 0 0 0 0 0 0 0 0 0 32 33 33 33 33 33 33 33 33 25 0 0 0 0 0 0 0 0 0 0 0 0 0 0 0 0 0 0 17 18 18 18 18 28 0 0 0 0 17 3 3 3 3
3 3 1 28 0 0 0 0 0 0 0 0 0 0 0 0 0 0 0 0 32 57 1 1 1 1 1 1 1 1 19 0 0 0 0 0 0 0 0 0 0 0 0 0 0 0 0 0 0 17 18 18 18 18 52 15 16 0 0 17 3 3 3 3
3 1 1 28 0 0 0 0 0 0 0 0 0 0 0 0 0 0 0 0 35 1 126 136 128 129 130 137 132 1 51 16 0 0 0 0 0 0 0 0 0 0 0 0 0 0 0 0 0 17 18 18 18 18 18 18 19 0 0 17 3 3 3 3
3 3 1 28 0 0 0 0 0 0 0 0 0 0 0 0 0 0 0 0 35 1 133 725 726 726 726 730 134 1 1 19 0 0 0 0 0 0 0 0 0 0 0 0 0 0 0 0 0 20 21 21 21 21 21 21 22 0 0 17 3 3 3 3
3 3 3 28 0 0 0 0 0 0 0 0 0 0 0 0 0 0 0 32 57 1 139 737 734 734 734 742 140 1 1 28 0 0 0 0 0 0 0 0 498 499 0 0 0 0 0 0 0 0 0 0 0 0 0 0 0 0 0 17 3 3 3 3
3 3 3 28 0 0 0 0 0 0 0 0 0 0 0 0 0 0 0 26 1 1 154 743 734 734 734 748 154 1 1 28 0 0 0 0 0 0 0 500 501 502 0 0 0 0 0 0 0 0 0 0 0 0 0 0 0 0 0 17 3 3 3 3
3 3 3 52 25 0 0 0 0 0 0 0 0 0 0 0 0 0 0 26 1 1 154 749 750 751 755 756 154 1 1 28 0 0 0 0 0 0 0 503 504 505 200 201 202 203 203 203 203 203 204 205 206 0 0 0 0 0 0 17 3 3 3 3
3 3 3 3 28 0 0 0 0 0 0 0 0 0 0 0 0 0 0 26 1 1 154 154 154 630 154 154 154 1 1 28 0 0 0 0 0 0 0 0 506 507 198 164 164 164 164 164 164 164 164 164 208 0 0 0 0 0 0 17 3 3 3 3
3 3 3 3 28 0 0 0 0 0 0 0 0 0 0 0 0 0 0 26 1 1 154 154 154 631 154 154 154 1 1 28 0 0 0 0 0 0 0 0 508 509 164 164 164 164 164 164 164 164 164 164 215 0 0 0 0 0 0 17 3 3 3 3
3 3 3 59 31 0 0 0 0 0 0 0 0 0 0 0 0 0 0 26 1 1 154 154 154 154 154 154 154 1 1 28 0 0 0 0 0 0 0 0 510 511 342 164 164 164 164 164 164 164 164 164 218 0 0 0 0 0 0 17 3 3 3 3
3 3 3 28 0 0 0 0 0 0 0 0 0 0 0 0 0 0 0 26 1 1 154 154 154 154 154 154 154 36 36 28 0 0 0 0 0 0 0 0 512 513 348 220 221 222 222 222 222 222 223 224 225 0 0 0 0 0 0 17 3 3 3 3
3 3 3 28 0 0 0 0 0 0 0 0 0 0 0 0 0 0 0 0 48 36 155 164 164 164 164 164 156 36 36 28 0 0 0 0 0 0 0 0 0 514 354 245 246 252 252 252 252 171 171 173 174 0 0 0 0 0 14 55 3 3 3 3
3 3 3 0 0 0 0 0 0 0 0 0 0 0 0 0 0 0 0 32 57 36 161 162 163 164 165 166 167 36 36 28 0 0 0 0 0 0 0 0 0 515 353 245 246 252 252 252 252 171 171 173 174 0 0 0 0 14 55 3 3 3 3 3
3 3 3 3 28 0 0 0 0 0 0 0 0 0 0 0 0 0 0 26 36 36 175 176 177 178 179 180 181 36 36 28 0 0 0 0 0 0 0 0 0 0 352 190 191 192 192 192 192 192 192 193 194 0 0 0 14 55 3 3 3 3 3 3
3 3 3 3 28 0 0 0 0 0 0 0 0 0 0 0 0 0 0 26 36 36 182 183 184 185 186 187 188 36 36 28 0 0 0 0 0 0 0 0 0 0 0 0 0 0 0 0 0 0 0 0 0 0 0 0 17 3 3 3 3 3 3 3
3 3 3 28 0 0 0 0 0 0 0 0 0 0 0 0 0 0 0 26 27 36 189 190 191 192 193 194 195 36 36 28 0 0 0 0 0 0 0 0 0 0 0 0 0 0 0 0 0 0 0 0 0 0 0 14 55 3 3 3 3 3 3 3
3 3 3 28 0 0 0 0 0 0 0 0 0 0 0 0 0 0 0 26 36 36 36 36 36 36 36 36 36 36 36 28 0 0 0 0 0 0 0 0 0 0 0 0 0 0 0 0 0 0 0 0 0 0 0 17 3 3 3 3 3 3 3 3
3 3 3 28 0 0 0 0 0 0 0 0 0 0 0 0 0 0 0 38 30 21 21 21 21 21 21 21 21 21 21 22 0 0 0 0 0 0 0 0 0 0 0 0 0 0 0 0 0 0 0 0 0 0 0 17 3 3 3 3 3 3 3 3
3 3 3 28 0 0 0 0 0 0 0 0 0 0 0 0 0 0 0 0 0 0 0 0 0 0 0 0 0 0 0 0 0 0 0 0 0 0 0 0 0 0 0 0 0 0 0 0 0 0 0 0 0 0 0 20 46 3 3 3 3 3 3 3
3 3 3 28 0 0 0 0 0 0 0 0 0 0 0 0 0 0 0 0 0 0 0 0 0 0 0 0 0 0 0 0 0 0 0 0 0 0 0 0 0 0 0 0 0 0 0 0 0 0 0 0 0 0 0 0 20 46 3 3 3 3 3 3
3 3 3 28 0 0 0 0 0 0 0 0 0 0 0 0 0 0 0 0 0 0 0 0 0 0 0 0 0 0 0 0 0 0 0 0 0 0 0 0 0 0 0 0 0 0 0 0 0 0 0 0 0 0 0 0 0 20 46 3 3 3 3 3
3 3 3 28 0 0 0 0 0 0 0 0 0 0 0 0 0 0 0 0 0 0 0 0 0 0 0 0 0 0 0 0 0 0 0 0 0 0 0 0 0 0 0 0 0 0 0 0 0 0 0 0 0 0 0 0 0 0 20 46 3 3 3 3
3 3 3 28 0 0 0 0 0 0 0 0 0 0 0 0 0 0 0 0 0 0 0 0 0 0 0 0 0 0 0 0 0 0 0 0 0 0 0 0 0 0 0 0 0 0 0 0 0 0 0 0 0 0 0 0 0 0 14 55 3 3 3 3
3 3 3 28 0 0 0 0 0 0 0 0 0 0 0 0 0 0 0 0 0 0 0 0 0 0 0 0 0 0 0 0 0 0 0 0 0 0 0 0 0 0 0 0 0 0 0 0 0 0 0 0 0 0 0 0 0 0 17 3 3 3 3 3
3 3 3 28 0 0 0 0 0 0 0 0 0 0 0 0 0 0 0 0 0 0 0 0 0 0 0 0 0 0 0 0 0 0 0 0 0 0 0 0 0 0 0 0 0 0 0 0 0 0 0 0 0 0 0 0 0 0 17 3 3 3 3 3
3 3 3 28 0 0 0 0 0 0 0 0 0 0 0 0 0 0 0 0 0 0 0 0 0 0 0 0 0 0 0 0 0 0 0 0 0 0 0 0 0 0 0 0 0 0 0 0 0 0 0 0 0 0 0 0 0 0 17 3 3 3 3 3
3 3 3 28 0 0 0 0 0 0 0 0 0 0 0 0 0 0 0 0 0 0 0 0 0 0 0 0 0 0 0 0 0 0 0 0 0 0 0 0 0 0 0 0 0 0 0 0 0 0 0 0 0 0 0 0 0 0 17 3 3 3 3 3
3 3 3 28 0 0 0 0 0 0 0 0 0 0 0 0 0 0 0 0 0 0 0 0 0 0 0 0 0 0 0 0 0 0 0 0 0 0 0 0 0 0 0 0 0 0 0 0 0 0 0 0 0 0 0 0 0 0 20 47 3 3 3 3
3 3 3 52 25 0 0 0 0 0 0 0 0 0 0 0 0 0 0 0 0 0 0 0 0 0 0 0 0 0 0 0 0 0 0 0 0 0 0 0 0 0 0 0 0 0 0 0 0 0 0 0 0 0 0 0 0 0 0 17 3 3 3 3
3 3 3 3 52 25 0 0 0 0 0 0 0 0 0 0 0 0 0 0 0 0 0 0 0 0 0 0 0 0 0 0 0 0 0 0 0 0 0 0 0 0 0 0 0 0 0 0 0 0 0 0 0 0 0 0 0 0 0 17 3 3 3 3
3 3 3 3 3 28 0 0 0 0 0 0 0 0 0 0 0 0 0 0 0 0 0 0 0 0 0 0 0 0 0 0 0 0 0 0 0 0 0 0 0 0 0 0 0 0 0 0 0 0 0 0 0 0 0 0 0 0 0 17 3 3 3 3
3 3 3 3 3 28 0 0 0 0 0 0 0 0 0 0 0 0 0 0 0 0 0 0 0 0 0 0 0 0 0 0 0 0 0 0 0 0 0 0 0 0 0 0 0 0 0 0 0 0 0 0 0 0 0 0 0 0 0 17 3 3 3 3
3 3 3 3 3 28 0 0 0 0 0 0 0 0 0 0 0 0 0 0 0 0 0 0 0 0 0 0 0 0 0 0 0 0 0 0 0 0 0 0 0 0 0 0 0 0 0 0 0 0 0 0 0 0 0 0 0 0 0 55 3 3 3 3
3 3 3 3 3 52 25 0 0 0 0 0 0 0 0 0 0 0 0 0 0 0 0 0 0 0 0 0 0 0 0 0 0 0 0 0 0 0 0 0 0 0 0 0 0 0 0 0 0 0 0 0 0 0 0 0 0 14 55 3 3 3 3 3
3 3 3 3 3 3 52 24 24 25 0 0 0 0 0 0 0 0 0 0 0 0 0 0 0 0 0 0 0 0 0 0 0 0 0 0 0 0 0 0 0 0 0 0 0 0 0 0 0 0 0 0 0 0 0 0 0 17 3 3 3 3 3 3
3 3 3 3 3 3 3 3 3 52 24 25 0 0 0 0 0 0 0 0 0 0 0 0 0 0 0 0 0 0 0 0 0 0 0 0 0 0 0 0 0 0 0 0 0 0 0 0 0 0 0 0 0 0 0 14 0 55 3 3 3 3 3 3
3 3 3 3 3 3 3 3 3 3 3 52 25 0 0 0 0 0 0 0 0 0 0 0 0 0 0 0 0 0 0 0 0 0 0 0 0 0 0 0 0 0 0 0 0 0 0 0 0 0 0 0 14 0 0 55 3 3 3 3 3 3 3 3
3 3 3 3 3 3 3 3 3 3 3 3 52 24 24 25 0 0 0 0 0 0 0 0 0 0 0 0 0 0 0 0 0 0 0 0 0 0 0 0 0 0 0 0 0 0 0 0 0 0 0 14 55 3 3 3 3 3 3 3 3 3 3 3
3 3 3 3 3 3 3 3 3 3 3 3 3 3 3 52 25 0 0 0 0 0 0 0 0 0 0 0 0 0 0 0 0 0 0 0 0 0 0 23 15 15 15 16 0 0 0 0 0 0 0 17 3 3 3 3 3 3 3 3 3 3 3 3
3 3 3 3 3 3 3 3 3 3 3 3 3 3 3 3 52 24 24 24 25 0 0 0 0 0 0 0 0 0 0 0 0 0 0 0 0 0 23 56 3 3 3 51 15 15 16 0 0 0 0 17 3 3 3 3 3 3 3 3 3 3 3 3
3 3 3 3 3 3 3 3 3 3 3 3 3 3 3 3 3 3 3 3 52 25 0 0 0 0 0 0 0 0 0 0 0 0 0 0 0 0 26 3 3 3 3 3 3 3 51 15 16 0 0 17 3 3 3 3 3 3 3 3 3 3 3 3
3 3 3 3 3 3 3 3 3 3 3 3 3 3 3 3 3 3 3 3 3 28 0 0 0 0 0 0 0 0 0 0 0 0 0 0 0 0 26 3 3 3 3 3 3 3 3 3 52 24 24 55 3 3 3 3 3 3 3 3 3 3 3 3
3 3 3 3 3 3 3 3 3 3 3 3 3 3 3 3 3 3 3 3 3 52 33 33 33 25 0 0 0 0 0 0 0 0 0 0 0 23 56 3 3 3 3 3 3 3 3 3 3 3 1 3 3 3 3 3 3 3 3 3 3 3 3 3
3 3 3 3 3 3 3 3 3 3 3 3 3 3 3 3 3 3 3 3 3 3 3 3 3 52 33 33 33 25 0 32 33 33 33 33 33 56 3 3 3 3 3 3 3 3 3 3 3 3 3 3 3 3 3 3 3 3 3 3 3 3 3 3
3 3 3 3 3 3 3 3 3 3 3 3 3 3 3 3 3 3 3 3 3 3 3 3 3 3 3 3 3 52 33 57 3 3 3 3 3 3 3 3 3 3 3 3 3 3 3 3 3 3 3 3 3 3 3 3 3 3 3 3 3 3 3 3
3 3 3 3 3 3 3 3 3 3 3 3 3 3 3 3 3 3 3 3 3 3 3 3 3 3 3 3 3 3 3 3 3 3 3 3 3 3 3 3 3 3 3 3 3 3 3 3 3 3 3 3 3 3 3 3 3 3 3 3 3 3 3 3
3 3 3 3 3 3 3 3 3 3 3 3 3 3 3 3 3 3 3 3 3 3 3 3 3 3 3 3 3 3 3 3 3 3 3 3 3 3 3 3 3 3 3 3 3 3 3 3 3 3 3 3 3 3 3 3 3 3 3 3 3 3 3 3