24 30
0 0 10 0 9 0 0 0 0 0 0 0 0 0 0 0 0 0 0 0 0 0 0 0
0 0 0 0 0 0 10 0 0 9 13 0 0 0 0 0 0 0 0 0 0 0 0 0
0 13 13 13 10 13 0 13 0 0 0 0 0 0 0 0 0 0 0 0 0 0 0 0
0 10 10 9 9 9 13 10 10 0 0 10 0 0 0 0 0 0 0 0 0 0 0 0
0 10 9 10 9 9 10 9 13 9 0 0 0 0 0 0 0 0 0 0 0 0 0 0
0 13 13 10 13 9 13 10 10 0 13 0 0 0 0 0 0 0 0 0 0 0 0 0
10 9 10 9 9 9 9 9 10 0 10 0 0 0 0 0 0 0 0 0 0 0 0 0
0 13 9 9 10 10 13 9 0 0 0 0 0 0 0 0 0 0 0 0 0 0 0 0
0 0 0 13 0 0 0 0 0 9 0 0 0 0 0 0 0 0 0 0 0 0 0 0
0 9 0 10 0 0 13 0 10 0 0 0 0 0 0 0 0 0 0 0 0 0 0 0
0 0 0 0 0 0 0 0 0 0 0 0 0 0 18 19 0 0 0 0 0 0 0 0
0 0 0 0 0 0 0 0 0 0 0 0 0 18 16 16 19 0 0 0 0 0 0 0
0 0 0 0 0 0 0 0 0 0 0 0 18 16 16 16 16 19 0 0 0 0 0 0
0 0 0 0 0 0 0 0 0 0 0 0 0 20 0 0 20 0 0 0 0 0 0 0
0 0 0 0 0 0 0 0 0 0 0 0 0 20 0 0 20 0 0 0 0 0 0 0
0 0 0 0 0 0 0 0 0 0 0 0 0 16 16 16 16 0 0 0 0 0 0 0
0 0 0 0 0 0 0 0 0 0 0 0 14 14 14 14 14 14 0 0 0 0 0 0
0 0 0 0 0 0 0 0 0 0 0 14 14 14 14 14 14 14 0 0 0 0 0 0
0 0 0 0 0 0 0 0 0 0 14 14 14 14 14 14 14 14 0 0 0 0 0 0
0 0 0 0 0 0 0 0 0 14 14 14 14 14 14 14 14 14 0 0 0 0 0 0
0 0 0 0 0 0 0 0 14 14 14 14 14 0 0 0 0 0 0 0 0 0 0 0
0 0 0 0 0 0 0 14 14 14 14 14 0 0 0 0 0 0 0 0 0 0 0 0
0 0 0 0 0 0 2 14 14 14 14 0 0 0 0 0 0 0 0 0 0 0 0 0
0 0 0 0 0 2 2 2 2 14 0 0 0 0 0 0 0 0 0 0 0 0 0 0
0 0 0 0 2 2 2 2 2 0 0 0 0 0 0 0 0 0 0 0 0 0 0 0
0 0 0 0 2 2 2 2 0 0 0 0 0 0 0 0 0 0 0 0 0 0 0 0
0 0 0 0 2 2 2 2 0 0 0 0 0 0 0 0 0 0 0 0 0 0 0 0
2 2 0 0 2 2 2 2 0 0 0 0 0 2 2 2 2 2 2 2 2 2 2 0
2 2 2 2 2 2 2 2 2 2 2 2 2 2 2 2 2 2 2 2 2 2 2 2
23 23 23 23 23 23 23 23 23 23 23 23 23 23 23 23 23 23 23 23 23 23 23 23