30 30
108 108 108 108 108 90 13 13 13 13 13 13 13 13 13 13 88 108 108 108 108 108 108 108 108 108 108 108 108 108
108 79 80 80 80 102 13 13 13 13 13 13 13 13 13 13 100 80 80 80 80 80 80 80 80 80 80 80 81 108
108 90 13 13 21 21 21 13 13 13 13 48 49 49 49 25 25 25 25 25 50 21 21 21 21 21 21 21 88 108
108 90 21 21 21 21 13 21 21 21 21 60 61 61 61 61 61 61 61 61 62 21 21 21 21 84 85 86 88 108
108 90 21 21 21 48 49 49 49 50 21 60 61 61 61 61 61 61 61 61 62 17 21 21 21 21 21 21 88 108
108 90 21 21 21 14 61 61 61 62 21 60 61 61 61 61 0 1 2 61 24 49 49 49 50 21 21 21 88 108
108 90 48 49 49 26 61 61 61 62 21 60 61 61 61 61 62 17 60 61 39 61 61 61 62 21 21 21 88 108
108 90 60 61 61 61 61 61 61 24 49 26 61 61 61 61 62 17 60 61 61 61 39 61 62 17 21 21 88 108
108 90 60 61 61 61 61 61 61 61 61 61 61 61 61 61 62 21 60 0 2 61 61 61 62 17 21 21 88 108
108 90 60 61 61 61 61 61 61 61 61 61 61 61 61 61 24 50 60 24 26 61 61 61 62 17 21 21 88 108
108 90 60 61 61 61 61 61 61 61 61 61 61 61 61 61 61 62 72 73 73 73 73 73 74 17 21 21 88 108
108 90 60 61 61 61 61 61 61 61 61 61 61 61 61 61 61 24 49 49 49 49 49 50 17 21 21 21 88 108
108 90 60 61 61 61 61 61 61 61 61 61 61 61 61 61 61 61 61 61 61 61 61 62 21 21 21 76 105 108
108 90 60 61 61 61 61 61 61 61 61 61 61 61 61 61 61 61 61 61 61 61 61 24 49 50 76 105 108 108
108 90 60 61 61 61 61 61 61 61 61 61 61 61 61 61 61 61 61 61 61 61 61 61 61 62 88 108 108 108
108 90 60 61 61 61 61 61 61 61 61 61 61 61 61 61 61 61 61 61 61 61 0 2 61 62 88 108 108 108
108 90 60 61 61 61 61 61 61 61 61 61 61 61 61 61 61 61 61 61 61 61 12 14 61 62 88 108 108 108
108 90 72 73 73 73 2 61 61 61 61 61 61 61 61 61 61 61 61 61 61 61 24 26 61 62 88 108 108 108
108 103 77 77 77 78 72 73 73 2 61 61 61 61 61 61 61 61 61 61 61 61 61 61 61 62 100 101 81 108
108 108 108 108 108 103 77 77 78 60 61 61 61 61 61 61 61 61 61 61 61 61 61 61 61 62 21 21 88 108
108 108 79 101 101 101 81 108 90 60 61 61 61 61 61 61 61 61 61 61 61 61 61 61 61 62 21 21 88 108
108 108 91 21 21 21 88 108 90 60 61 61 61 61 61 61 61 61 61 61 61 61 61 61 61 62 21 21 88 108
108 108 103 77 77 78 88 108 90 60 61 61 61 61 61 61 61 61 61 61 61 61 61 61 61 62 21 21 88 108
108 108 108 108 108 90 88 108 90 60 61 61 61 61 61 61 61 61 61 61 61 61 61 61 61 62 21 21 88 108
108 108 108 108 108 90 88 108 90 60 61 61 61 61 61 61 61 61 61 61 61 61 61 61 61 62 21 21 88 108
108 79 101 101 81 90 88 108 90 60 61 61 61 61 61 61 61 61 61 61 61 61 61 61 61 62 21 21 88 108
108 90 21 21 21 21 21 21 21 72 2 61 61 61 61 61 0 1 1 1 1 1 1 1 1 74 21 21 88 108
108 90 21 21 21 21 21 21 21 21 72 1 1 1 1 1 74 21 21 21 21 21 21 21 21 21 21 21 88 108
108 103 104 104 104 104 104 104 104 104 104 104 104 104 104 104 104 104 104 104 104 104 104 104 104 104 104 104 105 108
108 108 108 108 108 108 108 108 108 108 108 108 108 108 108 108 108 108 108 108 108 108 108 108 108 108 108 108 108 108